########################################
##...#####......########################
##.#####...##.#.########################
##.#####.####.#.########################
##.#####.####.#.#############.##########
##..###..####.#.############..##########
##......#######.###########...##########
##..###########...########....##########
###.###........##.E######.....##########
###.###.######.#########......##########
###.###.#....#.########.......##########
###.###.#.####.#######........##########
###.###...#....######.........##########
###.#######.#########..........#########
###.######..#########..........#########
###.####...##########.S........#########
###.###..####.#.####.............#######
###.###..###.###.#####............######
###.....#####...########..........######
###......############...............####
###..............................#######
##...#####......######............######
##.#####...##.#.############....########
##.#####.####.#.############.....#######
##.#####.####.#.########################
##..###..####.#.#############...########
##......#######.########################
##..###########...######################
##..###........##..#####################
###.###.######.#########################
###.###.#....#.#########################
###.###.#.####.#########################
###.###...#....#########################
###.#######.############################
###.######..############################
###.####...#############################
###.###..####.#.########################
###.###..###.###.#######################
###.....#####...########################
########################################